#######################################################################
#.....................................................................#
#...................................................^.................#
#..........................^.....^..................^.................#
#..........................^.....^..........G.......^.................#
#....^^^^^^^^^^^^^^........^.....^..................^.................#
#..........................^.....^.E................^.................#
#..........................^.....^..................^.................#
#................................^^^^^^^^^^.........^.................#
#.......^^^^^^^^^^^^^^^^^^^^^.........................................#
#.....................................................................#
#.M.............................^^^^^^^^^^^^^^^^^^^^^^^^^.............#
#.....................................................................#
#######################################################################