#######################################################################
#.....#......#......#.#........#...#.#.........#....^..#...#L#.......E#
#.###...###########...########.#.#...#.#########..^...^#....|.........#
#.#...#.#.........#.#..........#.###.#.#...#...##...B..#....|.........#
#####.#....######.#.#########.##..^#.#...#...#..#...........|.........#
#...#.######.#.#..#..#......#.#....#.######^##..#...........|.........#
#.#...#..#.#...#.##..#..^.#.#.######.#..#....#..#.^.........|.........#
#.######.#.#.#.#.###.####.#.#.^....^.##.#..^.#..#...........|.........#
#......#.#.#.#.#...#......#.########............#...........|.........#
##.###...#.#.#.#.#.^#######..........#.^#####^..............|.........#
#....#.#.....#.#.#..........####.#####..#.#.....#...........|.........#
#.M..#.#####.###.####.#######..#.^.#....^.#.#^#.#...........|.........#
#....#........#..#....#.......^..#...#.^..#.#.#.#..........#|#........#
#######################################################################